{
  "4": [
    "SFFF",
    "FHFH",
    "FFFH",
    "HFFG"
  ],
  "8": [
    "SFFFFFFH",
    "FFFHFFFF",
    "FFFFFHFF",
    "FFFFFFFF",
    "FFFFFFFF",
    "FFHHHFFF",
    "FHFFFFFF",
    "FHFFFFFG"
  ],
  "16": [
    "SFFFHFFFFFHFHFFH",
    "FFFFFFFFHFFFFFFH",
    "FHFFFFFFFFFFFFFH",
    "FFHFHFFFFFFFFFFF",
    "FFFFFFFFFHFFFFFF",
    "FFFFFFFFFFFFFFHH",
    "HFFFHFFFFFHFFFFF",
    "HFFFFFFFFFFFFFFF",
    "FFHFHFFFFHFFHFHF",
    "FHFFFFFFFFFFFFFF",
    "HFFFFFHFFFFHFFFH",
    "FFFFFFHFFFFFFHFF",
    "FFFFFFFFFFFHFFFF",
    "FFFFFHFFFFFFFFFF",
    "FFFFFFFHFFFFFHFF",
    "FFFFHFFFFFFFFFFG"
  ],
  "32": [
    "SFFFHFFFFFHFHFFHFFFFFFHFFFFFFHHF",
    "FFFFFFFFFFFFFFHFFHFHFFFFFFFFFFFF",
    "FFFFFFFFFHFFFFFFFFFFFFFFFFFFFFHH",
    "HFFFHFFFFFHFFFFFHFFFFFFFFFFFFFFF",
    "FFHFHFFFFHFFHFHFFHFFFFFFFFFFFFFF",
    "HFFFFFHFFFFHFFFFFFFFFFHFFFFFFHFF",
    "FFFFFFFFFFFHFFFFFFFFFHFFFFFFFFFF",
    "FFFFFFHFFFFFHFFFFHFFFFFFFFFFFFFF",
    "FFHFFFHFFFFFFFFFFFFHFFFFFHHFFFFF",
    "FFFFFHFFHFFFFFFHHFFFFFFHFFFFFFFH",
    "FFFFFFFFFFHFFFFFFFFHFFFFFFFFHFFF",
    "FFFFFFFHFFFFHFFFFFFFFFHFFFFFFHFF",
    "FFFFFFFFHFFFFFFFHFFFFFFFFFFFHFFF",
    "FFFFFHFFFHFFFFFFFHFFHFFFFHFFFFFF",
    "FFFFFFFFFFFFFFFFFFHFFFFFFFFHFFFF",
    "FFFFFFFHFFFFFFFFFFFHFFFFFHFHFFHF",
    "FFHFFFFFFFFHHFFFFFFFFFHFHFFFFFFF",
    "FHFFHHFFFFFHFFHFFFHFFFFFFFFFHFFF",
    "FFFFFFFFFFFFFHFFFFFHFFFFFFFFHFHF",
    "FFFFFFHFFFFFFFFFFFFHFHFFFFFFFFFH",
    "FFFHFFFFFHFFFFFFFHFFFFHFHFFFFHFF",
    "FFFFFFFFFFFFFFFFFHHFFFFFFFFFFFFF",
    "FFFFFHFFFFFHFFFFFHHFFFHFFFFFFFHF",
    "FFFFFFFHFFFFFFFFFFFFFFFFFFFFFFFF",
    "FFFFFFHFFFFFFHFFFHFFFFFFFFFFFFFF",
    "FFFFFFFFFFFFFFFFFFFFFFFHFFFFFFFF",
    "HFFFFFFFFFFFFFFFFFFFFFFFFHHFFFFF",
    "HFFFFFHFFFFFFFFHFFFFFFFFHFFFFFFF",
    "FFFFFFFFFFFFFFFFFFHFFFFFFFFFFFFF",
    "FFFFFFFHFFFFFFFFFFFFFFFHFFFFFFFF",
    "FFFHFFFFFFFHFHFFFFHFFFFFFFFHFFFF",
    "FFFFFFFFHFFFHFFFFHFFFFFFHFFFFFFG"
  ],
  "64": [
    "SFFFHFFFFFHFHFFHFFFFFFHFFFFFFHHFFFFFFFFFFFFFHFFHFHFFFFFFFFFFFFFF",
    "FFFFFFFFHFFFFFFFFFFFFFFFFFFFFHHHFFFHFFFFFHFFFFFFFFFFFFFFFFFFFFFF",
    "FFHFHFFFFHFFHFHFFFFFFFFFFFFFFFFFFFFFFFHFFFFHFFFFFFFFFFHFFFFFFHFF",
    "FFFFFFFFFFFHFFFFFFFFFHFFFFFFFFFFFFFFFFHFFFFFHFFFFFFFFFFFFFFFFFFF",
    "FFHFFFHFFFFFFFFFFFFHFFFFFFHFFFFFFFFFFHFFHFFFFFFHHFFFFFFFFFFFFFFH",
    "FFFFFFFFFFHFFFFFFFFHFFFFFFFFHFFFFFFFFFFFFFFFHFFFFFFFFFHFFFFFFHFF",
    "FFFFFFFFFFFFFFFFHFFFFFFFFFFFHFFFFFFFFHFFFHFFFFFFFHFFHFFFFHFFFFFF",
    "FFFFFFFFFFFFFFFFFFHFFFFFFFFHFFFFFFFFFFFHFFFFFFFFFFFHFFFFFFFHFFHF",
    "FFHFFFFFFFFHHFFFFFFFFFHFFFFFFFFFFFFFHHFFFFFHFFHFFFFFFFFFFFFFHFFF",
    "FFFFFFFFFFFFFHFFFFFHFFFFFFFFHFHFFFFFFFHFFFFFFFFFFFFFFFFFFFFFFFFH",
    "FFFHFFFFFFFFFFFFFHFFFFHFHFFFFFFFFFFFFFFFFFFFFFFFFHHFFFFFFFFFFFFF",
    "FFFFFHFFFFFFFFFFFHHFFFHFFFFFFFHFFFFFFFFHFFFFFFFFFFFFFFFFFFFFFFFF",
    "FFFFFFFFFFFFFHFFFFFFFFFFFFFFFFFFFFFFFFFFFFFFFFFFFFFFFFFHFFFFFFFF",
    "HFFFFFFFFFFFFFFFFFFFFFFFFHHFFFFFHFFFFFHFFFFFFFFHFFFFFFFFHFFFFFFF",
    "FFFFFFFFFFFFFFFFFFHFFFFFFFFFFFFFFFFFFFFHFFFFFFFFFFFFFFFFFFFFFFFF",
    "FFHFFFFFFFHFHFFFFHFFFFFFFFHFFFFFFFFFFHFFFHFFFFHFFFFFFFFFFFFHFFFF",
    "HFFFFFFFHFFFFFFHHFFFFHFFFFFFHFFHFFFFFHFFFFFHHFHFFFFFFFFHFFFFFFFF",
    "FFFHFFFFFHFHHFFFFFFFFFFFFFFFFFFFHFFFFFFFFFFHFFFFFFFHFFFFFHFFFFFF",
    "FFHHFFFFFFFFFFFFFFFHFFHFFFFFHFFFFFFFHFHHFFFFFFFHFFFFFHFFFFFFFFFF",
    "FFFFFFFFFFFFFFFFFFFFFFFFFFHFFFHFFFHFHFFFFFFFFFFFFFFHHFFFFFFFFFFF",
    "FFFFFFHHFFFFFFFFFFFFFFFFFFFFFFFFFFFFFFFFFFHFHFFFHFFFFFFFFFFFFFFF",
    "FFFFFFFFFFFFFFFFFFFFFFHFFFFFFFFFFFFHHFFFFHFFFFFFFFFFFHHFFFFFFFFH",
    "FFFFFFHFFFFFFFFHFHFFFFFFFFFHFFFFFFFHFFFFFFFFHFFFHFHFFFFFFFFFFFFF",
    "FFFFFFFFFFFHFFFFHFFFFFFHFFFFFFHFFFFFFFFHHFFFFFFFFFFFFFFFFFFFFFFF",
    "FFFFFFFFHFFFFHFFFFFFFFFFFFHFFFFFHFFFFFFHFFFFFFFFFFFFHFFFFFFFFFFF",
    "FFFFFFFFFFFFFFHHFFFFFFFFFFFFFFHHFFFFFFFFFFFFFFFFHFFFFFFFFFFFFFFH",
    "FFFFFHFFFFFFFFFFFFFFFHFFFFFFFFFFFFFFFHFFFFFFFFFFFFFFFFFFFFFFFFFH",
    "FFFFFFFFFFFFFHFHHFFFFFFFFHFFFFFFFFFFFFFFFFFFFFFFFFFFFFFFFFFFFFFF",
    "FFFFFFFFFFFFFFFFHFFHFHFFFFFFFFFFFHFFFFFFFFFFFFFFFFHFHFFFFFFFFFFF",
    "FFFFFFFFFFFFHFFFFFFFFFFFHFFHFFFFFFFFFFFFFFFFFFFFFFFFFHFFHFHFFFFF",
    "FFFFHFFFFFHFFFFFFFHFHFFHFHFFFFFFFFFFFFFFFFFFFFFHHFFFFFFFFFFFFFFF",
    "HFHHFFHFFFFFHFFFFFFFFFFFFFHFFFFFFFFFFFFFFFFFFFFFFFFFFFFFFHFFFFFF",
    "FFFFFFFFHFFFFFFFFFFFFFFFFFHFFFFFFFFFFFFFFFFFFFFFFFFFFFFFFFFFHHFF",
    "FFFFFFHFFFFFFFHFHFFFHFFFFHHFFFFFFFFFFFFFFFFHFFHHFFFFFFHFHFFFFHHF",
    "FFHFFFFFFFHFFFFFFFFFFFFHFFFFFFFHFFFFFFFFHFFFHFFFFFHHFFFFFFFFHFHF",
    "FFFFHFFFFFFFFFHFFFHFFFFFHFFFFFFFFFFFFFFFFFFFFFFFFFFFFFFFFFFFFFFF",
    "FFFFFFFHFFFFFFFFFFFFHFFFFHFFFFFFHFFFFFFFFFFFHHFFFFFFFFFFFFFFFFFF",
    "FFFFFFFFFFFFFHFFFFFFFFHHFFFFFFFFFFFFFFFFFFHFFFFFFFFFFFFFFFFFFFHF",
    "HFFFFFFFFFHHFFFFFFFFFFFFFFFHFFFHFFFFFFFFFFFFFFFFFFFFHFFFFFFFFFFH",
    "FFFFFFFFFFFFFFFFFFFHFFFFFFHFFFFFFHFFFFFFFFFFFFHHFFFFFHFFFFFFFFFF",
    "FFFFFFFFFHFFFFHFFFFFHFFHFFFFFFFFFHFFFFFFFFHHFFFFFFFHFFFFFFFFFFFF",
    "HFFFFFFFFFFFFFFFFFFHHFHHFFFFFFHFFFFFFFFFFFFHFFFHHFFFFFFFFFFFFFFF",
    "FFFFFHFFHFFHFFFFFFHFFFFHFFFFFFFFFFFFFFFHFFFFFFFHFFFFFHFFFFFFFFFF",
    "FFHFFFFFFHFFFHFFFHFFHFFFFFFHHFFHFFFFFFFFFFFHFFFFFFFFFFFFFFFFFHFF",
    "HFFFFFFHFFFFFFFHFFFFFFFFFFHHFFFFFFHFFFFFHFFFFFFHFFFFFHFFFFFFFFFF",
    "FFFFFFFFFFFHFFFFFHFFFFHFFFFFFFFFFFFHFFFFFFFFFFHFFFHFFFFFFFHFFFFF",
    "FFFFHFFFFFFFFFFFFFFFFFFFFFFFFHFFFFFFFFFFFFHFFFFFFHFHHFFFFFFFHFFF",
    "FFHFFFFHFFFFFHFFFHFFFFHFFFFFFFFHFFFFFFFFFHFFHFFFFFHFFFFFFFFFHFFH",
    "FFFFFFFFFFFFFHFFFFFFFFFFFFFFFFFFFFFFFHFFFFFFFFFFFFFFFFFHFFFFFFFH",
    "FFFFHFFFFFFHFFFFFHFFFFFFFFFFFFFFFFFFFFFFHFFFFFFFFFFFFHFFFFFFFFFF",
    "FFFFFFFFFFHFFHFFFHFFFFFFFFFFFFFHFFFFFFFHHFFFFFFFFFFFFFFFFFFFFFHF",
    "FFFFFFFFFFFFFHFFFFFFFHFFFFFFFFFFFFHFFFFFHFFFFFFFFFFFFFFHFFFFFFHF",
    "FFFFHFFHFFFFFFFFFFFFFFFFFFFFFFFFFFFFFFFFFFFHFFFHFFFHFFFFFFFFFFFF",
    "FFFHFFFHFFFFFFFHFFFFHFFFFFHFFHFFFFFHFHFFFFHFHFFFFFFFHFFFFFFFFFFF",
    "FHFFFFFFFFFHFFFFFFFHFFFFFFFFFFFFHFFFFFFFFHFFFFFHFFFHFFFFFFFFFFFF",
    "HFFHHFFFFFFFFHFFFFFFFFFFFFFFFFHFFFFHFFFFFFFHFFFFFFFFFFFHFFFFFFFF",
    "FFFFFFFFFFFFFFFFFFFFFFFFFFFFFFFFFFFFFFFFFFFFFFHFFFFFFFFFFFHFHFFF",
    "FFFFFFFFFFFFFHFFFFFFFFFFFFFFFFFFFFFFFFFFFFFFHFFFFFFFFFFHFFFHFFFF",
    "FFFFFFHFFFFFFFFFFFFFFFFFFHFFFFFFFHHFFFFHFFFFFFFFFFHHFFFFFFFFHFFF",
    "FFFFHFHFFHFFFFFFFFFFFFFFFFFFFFFHFFFFFFFFFFFFFFFFFFFFFFFHHFFFFFHF",
    "FFFFFFFFFFHFFFFFFFFFFFFFFFFFFFFHHHFHFFFFFFFFFFFFFFFFFFFFFFFFFFFF",
    "FFFFFFHFHFFFFFHFFFFFFFFFFFFFFFFFFFFFFFFFHFFFFFFFFFFFFFFHHFFFHFHF",
    "FFFFFHFFFHFFFFFFFFFFFFFFFFFHFFFFFHFFHFFFFFFFFFFFFHFFFFFFFFFHFFFF",
    "FFFFFFFFFFHFFFFFFFFFFFFFFFFFFFFFFFFFFFFFFFFFFFFFHHFFFHFHHFFFFFFG"
  ],
  "128": [
    "SFFFHFFFFFHFHFFHFFFFFFHFFFFFFHHFFFFFFFFFFFFFHFFHFFFFFFFFFFFFFFFFFFFFFFHFFFFFFFFFFFFFFFFFFFFHHFFFFHFFFFFHFFFFFFFFFFFFFFFFFFFFFFFH",
    "FFFHFFFFHFFHFHFFFFFFFFFFFFFFFFFFFFFFFHFFFFHFFFFFFFFFFHFFFFFFHFFFFFFFFFFFFFHFFFFFFFFFHFFFFFFFFFFFFFFFFHFFFFFHFFFFFFFFFFFFFFFFFFFF",
    "FFHFFFHFFFFFFFFFFFFHFFFFFFFFFFFFFFFFFHFFHFFFFFFHHFFFFFFFFFFFFFFFFFFFFFFFFFHFFFFFFFFFFFFFFFFFHFFFFFFFFFFFFFFFFFFFFFFFFFHFFFFFFHFF",
    "FFFFFFFFFFFFFFFFHFFFFFFFFFFFHFFFFFFFFHFFFHFFFFFFFHFFFFFFFHFFFFFFFFFFFFFFFFFFFFFFFFHFFFFFFFFHFFFFFFFFFFFHFFFFFFFFFFFHFFFFFFFHFFHF",
    "FFHFFFFFFFFHHFFFFFFFFFHFFFFFFFFFFFFFFHFFFFFHFFFFFFFFFFFFFFFFFFFFFFFFFFFFFFFFFHFFFFFHFFFFFFFFHFHFFFFFFFHFFFFFFFFFFFFFFFFFFFFFFFFF",
    "FFFHFFFFFFFFFFFFFHFFFFHFHFFFFFFFFFFFFFFFFFFFFFFFFHHFFFFFFFFFFFFFFFFFFHFFFFFFFFFFFHHFFFHFFFFFFFHFFFFFFFFHFFFFFFFFFFFFFFFFFFFFFFFF",
    "FFFFFFFFFFFFFHFFFFFFFFFFFFFFFFFFFFFFFFFFFFFFFFFFFFFFFFFHFFFFFFFFHFFFFFFFFFFFFFFFFFFFFFFFFHHFFFFFHFFFFFHFFFFFFFFHFFFFFFFFHFFFFFFF",
    "FFFFFFFFFFFFFFFFFFHFFFFFFFFFFFFFFFFFFFFHFFFFFFFFFFFFFFFFFFFFFFFFFFHFFFFFFFFFHFFFFHFFFFFFFFHFFFFFFFFFFHFFFHFFFFHFFFFFFFFFFFFHFFFF",
    "HFFFFFFFHFFFFFFHHFFFFHFFFFFFFFFHFFFFFHFFFFFHHFHFFFFFFFFHFFFFFFFFFFFHFFFFFHFHHFFFFFFFFFFFFFFFFFFFFFFFFFFFFFFHFFFFFFFHFFFFFHFFFFFF",
    "FFHHFFFFFFFFFFFFFFFHFFHFFFFFHFFFFFFFHFHHFFFFFFFHFFFFFHFFFFFFFFFFFFFFFFFFFFFFFFFFFFFFFFFFFFHFFFHFFFHFHFFFFFFFFFFFFFFHFFFFFFFFFFFF",
    "FFFFFFHHFFFFFFFFFFFFFFFFFFFFFFFFFFFFFFFFFFHFFFFFHFFFFFFFFFFFFFFFFFFFFFFFFFFFFFFFFFFFFFFFFFFFFFFFFFFHHFFFFHFFFFFFFFFFFHHFFFFFFFFH",
    "FFFFFFHFFFFFFFFHFHFFFFFFFFFHFFFFFFFHFFFFFFFFHFFFHFHFFFFFFFFFFFFFFFFFFFFFFFFHFFFFHFFFFFFHFFFFFFHFFFFFFFFHHFFFFFFFFFFFFFFFFFFFFFFF",
    "FFFFFFFFHFFFFHFFFFFFFFFFFFHFFFFFHFFFFFFHFFFFFFFFFFFFHFFFFFFFFFFFFFFFFFFFFFFFFFHHFFFFFFFFFFFFFFHHFFFFFFFFFFFFFFFFHFFFFFFFFFFFFFFH",
    "FFFFFHFFFFFFFFFFFFFFFHFFFFFFFFFFFFFFFHFFFFFFFFFFFFFFFFFFFFFFFFFHFFFFFFFFFFFFFHFFHFFFFFFFFHFFFFFFFFFFFFFFFFFFFFFFFFFFFFFFFFFFFFFF",
    "FFFFFFFFFFFFFFFFHFFFFHFFFFFFFFFFFHFFFFFFFFFFFFFFFFHFFFFFFFFFFFFFFFFFFFFFFFFFHFFFFFFFFFFFHFFHFFFFFFFFFFFFFFFFFFFFFFFFFHFFHFHFFFFF",
    "FFFFHFFFFFHFFFFFFFHFHFFHFHFFFFFFFFFFFFFFFFFFFFFHHFFFFFFFFFFFFFFFHFFHFFHFFFFFHFFFFFFFFFFFFFHFFFFFFFFFFFFFFFFFFFFFFFFFFFFFFHFFFFFF",
    "FFFFFFFFHFFFFFFFFFFFFFFFFFHFFFFFFFFFFFFFFFFFFFFFFFFFFFFFFFFFHHFFFFFFFFHFFFFFFFHFHFFFHFFFFFHFFFFFFFFFFFFFFFFHFFHHFFFFFFHFHFFFFHHF",
    "FFHFFFFFFFHFFFFFFFFFFFFHFFFFFFFHFFFFFFFFHFFFHFFFFFFHFFFFFFFFHFHFFFFFHFFFFFFFFFHFFFHFFFFFFFFFFFFFFFFFFFFFFFFFFFFFFFFFFFFFFFFFFFFF",
    "FFFFFFFHFFFFFFFFFFFFHFFFFHFFFFFFHFFFFFFFFFFFHFFFFFFFFFFFFFFFFFFFFFFFFFFFFFFFFHFFFFFFFFHFFFFFFFFFFFFFFFFFFFHFFFFFFFFFFFFFFFFFFFHF",
    "HFFFFFFFFFHHFFFFFFFFFFFFFFFHFFFFFFFFFFFFFFFFFFFFFFFFHFFFFFFFFFFHFFFFFFFFFFFFFFFFFFFHFFFFFFHFFFFFFHFFFFFFFFFFFFHHFFFFFHFFFFFFFFFF",
    "FFFFFFFFFHFFFFHFFFFFHFFFFFFFFFFFFHFFFFFFFFHFFFFFFFFHFFFFFFFFFFFFHFFFFFFFFFFFFFFFFFFHHFHHFFFFFFHFFFFFFFFFFFFHFFFHHFFFFFFFFFFFFFFF",
    "FFFFFHFFHFFHFFFFFFFFFFFHFFFFFFFFFFFFFFFHFFFFFFFHFFFFFHFFFFFFFFFFFFHFFFFFFHFFFFFFFHFFHFFFFFFHHFFHFFFFFFFFFFFHFFFFFFFFFFFFFFFFFHFF",
    "HFFFFFFHFFFFFFFHFFFFFFFFFFHHFFFFFFHFFFFFHFFFFFFHFFFFFHFFFFFFFFFFFFFFFFFFFFFHFFFFFFFFFFHFFFFFFFFFFFFHFFFFFFFFFFHFFFHFFFFFFFHFFFFF",
    "FFFFFFFFFFFFFFFFFFFFFFFFFFFFFHFFFFFFFFFFFFHFFFFFFHFFHFFFFFFFFFFFFFHFFFFHFFFFFHFFFHFFFFFFFFFFFFFHFFFFFFFFFHFFHFFFFFHFFFFFFFFFHFFH",
    "FFFFFFFFFFFFFHFFFFFFFFFFFFFFFFFFFFFFFHFFFFFFFFFFFFFFFFFFFFFFFFFHFFFFHFFFFFFHFFFFFHFFFFFFFFFFFFFFFFFFFFFFHFFFFFFFFFFFFHFFFFFFFFFF",
    "FFFFFFFFFFHFFHFFFHFFFFFFFFFFFFFFFFFFFFFFHFFFFFFFFFFFFFFFFFFFFFHFFFFFFFFFFFFFFHFFFFFFFHFFFFFFFFFFFFHFFFFFHFFFFFFFFFFFFFFHFFFFFFHF",
    "FFFFHFFHFFFFFFFFFFFFFFFFFFFFFFFFFFFFFFFFFFFHFFFHFFFHFFFFFFFFFFFFFFFFFFFFFFFFFFFHFFFFHFFFFFHFFFFFFFFHFHFFFFHFHFFFFFFFHFFFFFFFFFFF",
    "FHFFFFFFFFFHFFFFFFFHFFFFFFFFFFFFHFFFFFFFFHFFFFFHFFFHFFFFFFFFFFFFFFFHHFFFFFFFFHFFFFFFFFFFFFFFFFHFFFFFFFFFFFFFFFFFFFFFFFFHFFFFFFFF",
    "FFFFFFFFFFFFFFFFFFFFFFFFFFFFFFFFFFFFFFFFFFFFFFHFFFFFFFFFFFHFFFFFFFFFFFFFFFFFFHFFFFFFFFFFFFFFFFFFFFFFFFFFFFFFHFFFFFFFFFFHFFFHFFFF",
    "FFFFFFHFFFFFFFFFFFFFFFFFFHFFFFFFFHHFFFFFFFFFFFFFFFHHFFFFFFFFHFFFFFFFHFFFFHFFFFFFFFFFFFFFFFFFFFFHFFFFFFFFFFFFFFFFFFFFFFFHHFFFFFFF",
    "FFFFFFFFFFHFFFFFFFFFFFFFFFFFFFFHHHFHFFFFFFFFFFFFFFFFFFFFFFFFFFFFFFFFFFHFHFFFFFHFFFFFFFFFFFFFFFFFFFFFFFFFHFFFFFFFFFFFFFFHHFFFHFHF",
    "FFFFHFFFHFFFFFFFFFFFFFFFFFFFFFFFHFFHFFFFFFFFFFFFHFFFFFFFFFHFFFFFFFFFFFFHFFFFFFFFFFFFFFFFFFFFFFFFFFFFFFFFFFFFFHHFFFHFHHFFFFFFFFFF",
    "FFFFHFFFFHFHFFFFFFFFHHFFFFFFFFFFFFFHFFFFFFFFFFFFFFFFHFHFFFFFFFHFFHFFHFFFFFFFFFFFFFFFFFFFFFFFFHFFFFFFFFFFFFHFFFFFFFFFFFHFFFFFFFFF",
    "FFFFFFFFFFFHFFFFFFFFFFFFFFFFFFFFHFFFFFFFFFHFFFFFFFFFFFFFFFFFFFFFFFHFFFFFFFFFFFFFFHFFFFHFFHFFHFFHFFFFFFFFFFHFFFFFFFFFFFFFFFFFFFFF",
    "FFFFHFFFFHFFFHFFFHFFFFFFFFFFFFFFFFFFFFFFFFFFFHHFFFFFFFFFFFFFFFFFFHFHFFFFFFFFFFFHFFFFFFFFFHFFFFFFFFFFFFFFFHHFFFFHFHFFFFHFFFFFFFFF",
    "FFFFFFFFFFFFFFFFFFHFFFFHFFFHFFFFFFFFFFFFFFFHFFFFFHFFFFFFFFHFFFFHFHFFFFFFFHHFFFHFFFFFFFFFFFFFFFFFFFFFFFFFFFFFFFFFFFFFFFFFFFFFFFFH",
    "FFFFFFFHFFFFFFHFFFFFFFFFFFFFFHHFFFFFFFFFHFFFHFFFFHFFFFFFFFFHFHFHFFFFFFFFFFFHFFFHFFFFFHFFFFFFHFFFFFFHFFFFHFFFHFFFFFFFFFHFFHFFFFHF",
    "HFFFFFHFFFFFHFFFFFFFHFFFFFFFFFFFFFFFFHFFFFFHFFFFFFFFFFFFFFFFFFFFFFFFFFFFFFFFFFFFFFFFFFFFFFFFFFFFFFFFFFFFFFHFHFFFFFHFFFFFFFFHFFFF",
    "FFFFFFFFHFFFFFFFHFFFFFFFHFFFFFFFFFFFFFFFFFFFFFFFFFFFFFFFFFFFFFFFFFFFFFFFFFFFFFFHFFFFFHFFFFFFHFFHFFFFFHFFFFFFFFFFFHFFFHFFFFFFFFFF",
    "FFFFFFFFFFFFFFFFFFFFFFFHHFFFFFFFFFHFFFFFFHFFFFHFFFFFFFFFFFFFFFFFFFFFFFFFFFHFFFFFFFFFFHFFFFFFFFFFFFHFFFFFFFFFFFFFFFFFHFFFHFHFFFFF",
    "FFFFFFFFFHFFFFFFFFFHFFFFFFFHFFFFFFFFFFFFFFFFFFFFFFFFFFFFFFFFFFHFFFFFFFFFFFFFFFFFFFFFFFFFFFFFHFFFFFFFFFHFFFFFFHFFFFHFFFFFFFFFFFFF",
    "FFHHFFFFFFHFFFFFFFFFFFFFFFFFFFFFFHHFFFFHFFFFFFFFFFFFFFFFFFFFFFFFFFFFFFFFHFHFFFHFFFHFFFFFFFFFFHFFFFHFFHFFFFHFFFFFFHFFFFFFFFFFFFHF",
    "FFFFFFFFFFFFFFFFFFFFFFFFFHFFFFFHFFFFFFFFHFFFFFFFFFFFFFHHFFFFFHHFFFFFFFFFFFFFFFFFFFFFFFFFFHFFFHFFFFFFFFFFFFFFFHFFFFFFFFFFFFFFFFFF",
    "FFHFFFFFFFFFFHFFHFFFFHFFFFFFHFFFFFFFHFFFFFFHHFHFFFFFFFFFHFFFFHFFFHFFFFFFFFFFFFFFFFFFFFFFFFFFFFFFFHHFFFHFHFHFFFFFFFFFFFFHFFFFFFHF",
    "FFHFFFFFFFFFFFFFFHFFFFFFHFFFFFFFFFFFFFFFHFFFFFFFFFFFFFFFFFFHFFFFFFFFFFFFFHFFFFFFFFFFFFFFFHFHFFHFFFFFFFHFFFFFHFFFFFHFFFFFFFFFHFFH",
    "FFFFFFHFFHFFFFFFFFFHFFFFFFFFFFFFFFFFHFFFFFFFFFFFFFHFFHFFFFFFFFFFFFFFFFFFHFFFFFFFFFFFFFFFFFFFFHFFFFFFFFFFFFHFFFFFHFFFFFFFFFFFFHFF",
    "FFFFFFFFFFFFFFFFFFFFHHFFFFFHFFFHFFFFFFFFFFFFFFFHFFFFFFFFFFFHFFFFHFFHFFFFFFFFFFHFFFFFHHFFFFFFFFFFFFFHFFFFFFFFFFFFHFFFFFFFFFFFFFFH",
    "FFFFFFFFHFFHFFFFFFFFFFFFFFFFFFHFFFFFFFFFFFHFFFFFFFHFFHFFHFFFHFFHFFFFFFFFHFFFFFFFFFHFHFFFFFFHFFFFFFFFFFFFFFFFFFFFHFFFFFFFFFFFHFFF",
    "FFFFFFHFFFFFFHFFFFFFFFFFFFFFFFFFFFFFFFFHHHFFFFFFHHFFFFFFFFFFFHFFFFFFHFFFFFFFFFFFFFFFFFFFFFFFHHFFFHFFHFFFFFFFFHFFHFFFFFFFFFFFFFFF",
    "FFFFFFFFFFFFFHFFFFHFHFHFFFFFFFFFFFFFFFHFFFFFFFFFFFFFFFFFFFFFFFHFFFFFFFFFFFFFFFHFFFFFFFFFHFHFFFFFFHFFFFFFFFFFFFFFFFFFFFFFFFFFFFFF",
    "FFFFFFFFFHFFFFFFFFFFFFFFFFFFFFFHFFFFFFFFFHFFFFFFFFFFFFFFFFFHHFFFFFFFHFFFFFFFFFFFFFFFFFFFFFFFFFFFFFFFFFFHFFFFFFFFFFFFFFFFFFFFFFFF",
    "FFFFFFFHFFFFFFFFHHFFFFFFFFHFFFFFFFFFFFFFFFFFHFFFFFFFFFFFFFFFFFFFHFFHFFFFFHFFFFFFFHFFFFFFFFFFFFHFFFHFFFFFFFHFFFFFHFFFFFFFFFHFFHHF",
    "FFFFFHFFFFFFFFFFFFFFFFFFFFFFFFFFHFFFFFFFFFFFFFFFFFFHHHFFHFFFFHFFFFFFHFFFFFFFFFFFFFFFFHFFFFFFFFFFFFFFFFHFHFFFFFFFFFFFFHFFFFFFFFFF",
    "HHFFFFFFFFFFFFFFFFFFFHFFFFFFFHFFFFFFFFFFFFFFFFFFFFFFFFFFFFFFFFHHFFFFFHHFFFFFFFHFFFFFFFFFFFFFFFFFHFFFFFFFFFHFFFFFFFFFFFHFFFFFFFFF",
    "FFFFFFHFHFFHFFFHFFFFHFFFFFFFFFFFHFFFFFFFFFFFFFFFHFFFFFFHFFFFHFFFFFFFHFFFHFFFFFFFFFFFFFFFFFFFFFFFFFHFFHHFFFFFFFFFFFFFFFFFFFFFFFFF",
    "FFFFFFFFHFFFFFFFFHFFFFFFFFFFFFFFFFFFFFFFFFFFFFFFFFFFFFFFFFFFFFHFFFFFFFHFFFFFFFFHFHFFFFFFHFFFHFFFFFHHFFFFFFFFFFFFFFHFFFFFFFFFFFFF",
    "FHFFFFFFFFFFHFFFFHFFFFFFFFFHFFFFFFFFFFFFFFFFFFFFFFHFFHFFFFFFFFFFHHFFFFFFFFFFHFFFFHFFFHFFFFFFFFFFFFFFFFFFFFFHFHFFFFFFFFFFFFFFFFHF",
    "FFFFFFFFFFFFHFHFHFFFHFFFFHFFFFFFFFFHFFFFFFFFHHHFFHFFFFFHFFFFHFFFFHFFFFFFFFFFFFHFFFFFFFFFFHFFFFFFFFFFFHFFHFFFFFFFFFFFFFFFFFFFFFHF",
    "HFFFFFFFFFFFFHHFFFFFHHFFFFFFFHFFHFFFFFFFFFFFFFFHFFFFFFFFFHFFFFFHFFFFFFHFFHFFFFFFFFFFFFFFFHFFFFFFFFFFFHFFFFFFFFFFFFFFFHFFFFFHHHFF",
    "FFFFFFFFFFFHFFFFFFFFFFFFFFFFFFFFFFFFFFFFFFFFHFFFFFFFFFHFFFFFFFFFFFFFFFFFFHFFHFFFHFFFFHHFFFFFFFFHFFFFFFFFFFFFFHFHFFFFFFFFFFFFFFFF",
    "FFFFFFFFFFFFFFFFFFFFFFFHFFFFFFFHFFFFFFHFFFFFHFFFFFFFHFFFFHFFFFFHFFFFFFFFFFHHFFFFFHFFFFFFFFFFFFFFFFFFFFFFFFFFFHFFFHFFFFFFFFFFFFFF",
    "FFFFFFFFFFFFFFFFFFFFFFFHFFFFHFFFFFFFFFFFFHFFFFFFFFFFFFFHFHFFFFHFFFFHFFFFFFFFFFFHFFFFFFFFFHFFFFFFFFFFFFHFFFFHFFFFFFFFFFFHFFFFFFFF",
    "FFFFFFFFHFFFFFFFFFFFFHFFFFFFFFFFFFFFFFFFFHFFFFFFFFFFHHFFFFFFFFFFFFFHFFFFFFFFFFFFFFFFFHFHFFHFHFFFFFFFFFFFFFFHFFFFFFFFFFFFFFFFFFFF",
    "FFHFHFFFFFFHFFFFFFFFFFFFFFFFFFFFFFFFFFFFHFFFFFFFFFFFFFFHFFFFFFFFFFFFFFFFHHFFFFFFFFHHFFFFFFFFFFFFFFFFFFFFFFFFFFFFFFFFFFFFFFFFFHFF",
    "FFFFFFFFFFFFFFFFFFFFFFFFFFFFFFFFFHFFFFFFFFFHFFHFFFFFFHFFFFFFFFFFFFFFFFHFFFHFFFFFFFFFFHHFFFFHFFFFFFFFFFFFFFFFFFFFFFFHFFFFFFHFFFFF",
    "FFFFFFFFHFFFFFFFFFFFHFFFFHFFFFHFFFFFFFFFFFFHFHFFFHFFFFFFHFFFFFFFFFFFFFFFFFFFFFFFFFFFHFFFFFHFFFFFFFFFFFFFFFFFFFFHHFFFHFFFFFFFFFFF",
    "FFFFFFFFFFFFFFFFFFFFFFHFFFFFFFFFFFFFFFFFFFFFFHFFFFFFFHFFFFFHFFFFFFFFFFFFFFFFFFFFFFHFFFFFFFFFFFFFFFFFFFFFHFFFFFFFFFFFFFFFFFFFFFFF",
    "FFFFFFFFFHFFFFHHFFFFFFFFFFFFFFHHHFFFFFFFFFHHFFFFFFFFFFFFFFFFFFFFFHFFFFFFHFFFFFFFFFFFHFFFHFFFHFFFFFFFFFFFFFFFFFFFFFFFFFFFFHFHFFFF",
    "FFFFFHFFFHFFFFFFHFFFFFFFFFFFFFFFFFFFFFFFFFFFFHFFFFFFFHFFFFHHFFFFFFFFFHFFFHFHFFHFFFFFFFFFFFFFHFFFFFFFFFFHFFFFFFFFFFFFFFFFFFFFFFFF",
    "FFFFFFFFFFFHHFFFFFFFFHFFFHFFFFFFFFFFFFFFFFFFFFFFFFFHFHFFFHFFFFFFFFFFFHFFFFHFFFFHFFHFHHFFFFFFFFFFFFFFFHFFHFFFFFFFFFFFFFFFFFFFFFFF",
    "FFFFFFFFHFFHFFHFFFFFHFFFFFHFFHFFFFFFFFHFFFFFFFFFFFFFHFFFFFFFFFFFFFFFFFFFFFFHFFFFFFFFFHHFFFFFHFFFFFFFFFFHFFFFFFFFFFFFFFFFFFFHFFFF",
    "HFFHFFFFHFFFFFFFFFFFFHFFFFHFFFFFFHFFFFFHHFFFFFFFFHFFFFFFFFFFFFFHFFHFFFFFFFFFFFFFFFFHFFFFFHFFFFFFFFFFHFHFFFFFFFFFFFFFFFFFFFFFFFFF",
    "FFFFFFFFFHFFHFFFFFFFFFFFFFFHFFFFFFFFFFFHFFFFFFFFFFFFFFFFFFFFFFHFFFFFFFFFFHFFFHFFHFFFFFFFFFFFFFFFFFFFFFFFFFFHFFFFFHHFHFFFFFFHFFFH",
    "FFFFFFFFFHHFFFFFFFFFFFFFFFFFFFFFFFFFFFFFFFFFFFFFFFFFHFHFFFFFFFHFFFFHFFFFFHFFFFFFFFFFFFFHFFFFFFFFFFFFFFFFFFFFFFFFFHFHHFFFFFFFFFFF",
    "FFFFFHHHFFFFFFFFFFFFFFFFHFFFFFFFFFFFFFFFFFFFFFFFFHFFFFFHFHHFFFFFFFFFFFFFFFFFFFFFFFFFFFFFFFFHFFFFHFFFFHFHFFFFFFFFFFFFFHHFHFFFFFFF",
    "FFFFFFFFHFFFFFFFHFFFHFFFFHFFFFFFFFFFFFFFFHFFFFFFFFHFFFFFFFFFFHFFFFFFFFFFFFFFFFFFFFFFFFFFFHFFFFFFFFFFFFFFFFFFFHHFFHFFFHFFFFFFFHFF",
    "FFHFFFFFFFHFFFFFFFFFFFFHFFFFFFFFFFFFFFFHFFFFFFFFFFFFFFFHFFFHHFFFHFFFHFFFHFFFFFFFFFFHFFFHFFHFFFFHFFFFFFFFFFFFFFFFFFFFFFFFFFFFFHFF",
    "HFFFFHFFFFFFFFFFFFHFFFFFFFFFFFFFFFFFFFFFFFFFHFFHFFFFFFFFFFFFFHFFFHFFFFFFFFFFFFFFFFFFFFFFFFFFFHFFFFFFFFFFFFHFFHHFFFFFFFFFFFHFFHFF",
    "FFFHFFFFFHFFFFFFFFFFFHFFFFHFFFFHFFFHHFFFFFFHHFFFFFFFHFFFFFFFFFFFHFFFFFFFFHFFHFFHFFFFFFFHFFFFFFFFFFFFFFFFHFFFFFFFFFFFFFFFFFFFHFFF",
    "HFFFFFHFFFHFFFHFFFFFFFFFFFFFHFFFFFFFFFFFFFFFHFFHFFFFFFFFFFFFFFFFFFFFFFHFFFFHFFFFFFFFHFHFFFHFHFFFFFFFFFHFFFFFFFFFFFFFFFFFFFHFFHFF",
    "FFFFFFFHFFFHHFFFFFFFFFHFFFFFFFFFFFFFFFFFFFFFFFFFFFFFFFFFFFHFFFFFFFHFFFFFFHFFFFFFFFFFFFFFFFFHFFFFFFFFFFFFFHFFFFFFFFFHFFFFFFFFFFFF",
    "FFFFFFHFFFFFFFFFFFFFFFHFFFFHFHFFFFFFFFFFFFFFFFFFHFFFFFFFFFFFFFFFFFFHFHFFFFFFFFFFFFFFHHFFFFFFFFFFFFFFFFFFFHFFFFFFFFFFFFFFFFFFFFFF",
    "FHFFFFFFFFFFFFFFFFFFFFFHFFHFFFFFFFFFFFFFFFFFFHHFFFFFFFFFFFFFFFFHHFFFHFFFFFFFFFFHFFFFFFHFFFFFFHFFFFFFFFFFFFFFFHFFFFFFFFFFFFFFFFFF",
    "HFFFFFFFFFFFHFFFFFFFFFHFFFFFFFFFFFFFFFFFFFFFFFFFFFFFFFHFFHFFFFFFHFFFFFFFFFFFFFFFFFHFFFFFFFFFFFFFFFFFFFHFFFFFFHFFFFFFFFFFFFFFFFFF",
    "FFFFFFFFFHFFFFFFFFFFFHFFHFHFFFFHFFHFFFFFFFFFFFFFFHHFFFFFFFHFHHFFFFHFFFFFFFFFFFFHFFFHFFFFFFFHFFFFFFFFHFFFFFFFFHFFFFFFFFHFFFFFFFFF",
    "FFFFFFFFFHFFFFFFFFFFFFFHFFFHFFFFFFFFHFFFHFFFFFFFFHFFFFFFFFFFFFFFFFFFFFHFFFFFFFFFFFFFFFFFHFFFHFFHFFFFFFFFFFFFFFHFFFFFFFFFHFFFFFFF",
    "FFFFFFFFFFFFFFFFHFFFFFFHFFFFHFFFFFFFFFFFFFFFFFFFFFFFFFFFFFFFFHFFFFFFFFFFFFFHFFFFHFFHHFFFFFFFFFFFFHFFFFFFFHFFFHFFFFFFFFFFFFFFFFFF",
    "FFFFFFFFFHFFFFFFFHFHFFFFFFFFHFFFFFFFFFHFFFFFFFFFFFHFFFFFHFFFFFFFFHFFFFFFFFFFFFFFFFFFFFFFFFFFFFFFFFFFFFFFFFFFFFFFFFFFHFFFFFFFFFFF",
    "FFFFFFFFFFFFFFFFFFFFHHFFFFHFFFFFFFHFFFFFFFFFFFFFFFFFFFFFFFHFHFFFFFFFFFFFFFFFFFFFFFFFFFFFFFHFFFFFFFFFFFFFFFFFFFFFHFFFFFFFFFFFFFFF",
    "FFFFFHFHFFFFFHFFFFFFFFFHFFHFFHFFHFFFFFFFFFFHFFFFFFFFFFFFFFHFFFFFFFFFFFFFFFFFFFFFHFFFFFFFFFFFFFFFFFFFFFFFFFFFFFFFFFFFFFFFFFFFFFFF",
    "FFHFFFFFFFFFFFFFFFFFFFFHFFFFFFFFFFFFFFFFFFFFFFHFFFFFFHFHFFFFFFFFFFFFFFFHFFFFHFFFHFHFFFFFFFFFFFFFHFFFFFFFFFFFHFFFFFFHFHFHFFFFFFFF",
    "FFFFFFFFFHFFFFFFFFFFFFFFFFFFFFFFFFFFFFFHFFFFFFFFFFFFFFFFFHFFFFFFFFFFHFFFFFFFFFFFFFFHFFFFFFFFFFFFFFFFFFFFFFFFHFFHFFFFHFHFFFFFFFFF",
    "FFFFFFFFFFFFFFFFHHFFFFFFFFFFFFFFFFFFHFFHFFFHFFFFFFFFFFFFFFFFFFFFFFFFFFFHFFFFFFFFFFFFFHFFFFFFFFHFFFFFFFFFFFFFFFFFFFFFFFFFFFFFFFFH",
    "FFFFFFHFFFFFFFFFFFFHFFFFFFFFFFHFFFFFFFFFFHFFFFFFFFFFFFFFFFFFFFFFFFFFFFFFFFFFFHFFFFFFFFFFFFFFFFFFFFFFFFFFFFFFFFFFFFFFHFHFHFFFFFFF",
    "FFFHFFFFFFFFFFFFFFFFFFFFFFFFFFFFFFFFFFFFFFFFFFFFHFFFFFFFFFFFFFFHFFHFFFFFFFFFFHFHFFFFFFFFFFFFFFFFFFFFFFFFFFFFFFFFFFFFFFFFFFHFFFFF",
    "FFHFFFFHFFFFFFFFFFFFFFFFFFFFFHFFFFFFFFFFFFFFFFFHFFFFFFFFHFFFFFFFFFFFFHFFHFFFFHFHFFFFFFFFFFFFFFFFFFFHHFFFFFFFFFFFFFFFFFFFFFFFFFFF",
    "FFFFFFFHFFFFFFFFFFFFFFFHHFFFFFFFFFHFFFFFFFFHFFFHFFFFFFFFHFFFHFFFHFFFFHFFFFFFFFHFFFFFFFFFFFFFFFFFFFFFFFFFFFFFFFFFFFFFFFFFFFFFFFFF",
    "FFFFFFFFFFFFHFFFFFFFFFFFFFFFFHFFFFFHFFFFFHFFFFFFFFFFFFFFFFFFHFFFFFFFFFFFFFFFFFFFFFFFFHFFFFFFFFFFFFFFFFFFFFFFFFFFFFFFFFFFFFFFFHFF",
    "FFFFFFFFFFFFFFFFFFFFFFFFFFFHHFHFFFFFFFFFFFFFFFFFFFFFFFFFFFFFFFFFFFFHFFFFFFFFFFFFHFFFFFFFFFFFHFFHFFFFFFFFFFHFFFFHFFFHFFFFFHFFFHFF",
    "FFFFFFFFFFFFFHFFFFFFFHFFFFFHHFFFFFFFFFFFFFFHHFHFFHHFFFFFFFFFFHFHFFFFFFFHFFFFFFFFFFFFFFFFFHHFFFFHFFHFHFFFFFHFFFFFFFFFFFHFFFFFFFFF",
    "FFFHFFFFFHFFFFFHFFFHFFFFFFFFFFFHFHFFFFFFFHFFFFFFFFFFFFFHFFFFFFFFFFFFFFFFFFFFFFFFHFHFFHFFFFFFFFFFFHFFFFFFFFFFFFFFFFFFFFFFFFHFFHFF",
    "HFFFFFFFFFFFFFFFFFFFFFFFFFFFHFFFFHFFHHFFFFFFFFFFFFFFFFFFFFFFFFHFFHFFFFFFFFHFFFFFHFFFHFFFFFFFFFFFFFFFFFFFFHFFFFFHFFFFFFFFFFFHFFFF",
    "FFFFFFFFFFFFFFFFFHFHHHHFHFFFHFFFFFFFFHFFFFFFFFFFFFFFFFFFFHFHFFFFHFFFHFFFFFFFFFFFFFFHFFFFFFFFHFFFFFFFFFFFFFFFFFFFFHFFFFFFFFFFFFFF",
    "FFFFFFFFFFFFFFFFFFFFFFFFFFFFFFFFFFFFHFFFFHFFFFFHFHHFFFHFFFFFFFFFFFFFHFHFHFFFFHFFFFFHHFFFFHFFFFFFFHFFFFFHFFFFFFFFFFFHFFFFFFFFFFFF",
    "FHFFFFHFFFFFFFFFFFFFFFFHFFFFFFFFHFFFFFFFFFFFFFFFHFFFFFFFFHHFFFFHFFFFFFFFHFFFFFFFFHFFFFFFFFFHFFFHFFFFFFFFFFFFFFFFFHHHFFFFFFFFFFFF",
    "FFFFFFFFFFFHFFFFFFFFFFFFFFFFFFFFFFFFFFFFFFFFFFFFFFFFFFFFFFFFFFFFFHFFFFFFFFFHFFFFFFFFFHFFFFFFFFFFHFFFFFFFFFFFFFFFFFFFHFFFFHFFFFFF",
    "FFFFFFFFHFFFFFFFFFFFFFFFFFFFFFFFFFFFFFFFHFFFFFFFFFFFHFFFFFFFFFFFFFFHFHFHHFFFFFFFFFFHHFFFFFFFFFFFFHFFFFFFFFFFHFFFHFHFHFFFFFFFFFFF",
    "FHFHFFFFFFFFFFFFFFFFFFFFFFFFFFFFFHFFFFFFFFFHFFFFFFFFHFFFFHFFFFFFFFFFFFFFFFFFFHFFHFFFFFHFFFFFHFFFHFFFFFFFFFHFFHFFFFFFFFFFHHFFFHFF",
    "FFHFFFFFFFFFFFFFFFFFFFFFFFFFFFHFFFFFFFFFFHFFFFFHFFFHFFFFFFHFFFFFFFFFFFFFFFHHFHFFHFFFFHFFFFFFFFHFFHFFFFFFFFFFFFFFHFFFFHFFHFFFFFFF",
    "FFFFFFFFFFHFFFFFHFFFFFFFFFFFFFHFFHHFFFFFFFFFFFFFFFFHFFFFFFFFFFFFFFFFFFHFFFFFFFFFFFFFFFFFFFFFHFFFFFFFFFFFFFFFHFFFFFHFFFFFFFFFFFFF",
    "FFFHFFFFFFFFFFFFHFFHFFFFFFFFFHFFFFHFFFHFFFFFFFFFFFFFFHFFFFFFFFFFFFFFFFFFFFFFFFFFFFFFHFFFFFFFFFHFHFFFFFFFFHFFFFFFFFFFHFFFFFFHFFFF",
    "FFFFHFHFFHFFFFFFFFHFFFFFFFFFFFFFFFFFFFFFHFFFFHHFFFFFFFFFFFHFFFFFHFFFFFFFHFFFFFFHFFFFFFFFFFFFFFFFFFFFFFFFFHFFFFFFFFFFFHFFFFFFFFFF",
    "FFFFFFFFFFFFFFFFFFFFFFFFFFHFFFFFFFFFFFFFFFFFFFFFHFFFFHFFFFFFFFFFFFFHFFFFFHFFFFFFFFFFFFFFFFFFFFFFFFFFFFFFFHFFFFFFHFFFFFFFHFFHFFFF",
    "FFFFFFFFFFFFFFFHFFFFFFFFFFFFHFFFFHFFHFFFFFFFFFFFFHFFFHFHFFFFFFFFFFFFFFFFFFFFFFFFFFFFFFFHFFFHFFFFFFFFHFFFFHFFHFHFHFFFHFFFFFHFFFFH",
    "FFFFFHHHFHFHFFFFHFFHFFFFFFFFFFFFFFFFFFFFFFFFFFHFHFHFHFFFFFFFFFFFFFFFFFFFHFFHFFFFFFHFFFFFHFHFFFFFFHFFFFFFFFFFFHFFHFFFFFFFFFFFFFFF",
    "FFFHFFFFFFFFFHFFFFFFFFHHFFFFFFFFFFFFFFFFFFFHFHFHFFFFFFFFFFFFFFHFFFFFFFFFFFFFFFFFFFFFFFFFFFFFFHFFFHFFFFFFFFFFFFFFFFHFFFFFHFHFFFFF",
    "FFFFFFFFFFFFHFFFHFFFFFFFFFFFFFFFHFFFFHHFFFFFFHFHFFFFHFFFFFFFFFFFFFFFFFFFFFFFFFFFFFFFFFFFFFFHFFFFHFFFFFFFFFFFFFFFFFFFFFFFHFFFFFFF",
    "FFFFFFFFFFFFFFFFFFHFHFFFFFFFFFFFFFFFFFFFFFHFFHFFFFFFFHFFFFFFFHFFFFFFFFHFFFFFFFFFFFFFFFFFFFFFHFFFFFFFFFFHFFFFHFFHFHFHFHFFFFFFFFFF",
    "FHFFFFFFFFFFFFFHFFFFFFFFHFHFFFFFFHFFFFFFFFFFFFFFHFFFFFFFFFFFFFFFFFFFFHFFHFFFHFFFFFFFFFFFHFFFFFFFFFFFFFFFFFFFFFFFFFFHFFFHFFFFFFFF",
    "FFFFFFFFHFHFFFFFFFFHFFFFFFHFFHFFFFFHFFFFFFFHFFHFHFFFFFFFFFFFFFFFFFFFFFFFFFFFFFFFFHFFFFHFFFFFFFFFFFFFFFFFFFHFFFFFFFFFFFFFHFFFFFFF",
    "FFFFFFFFFFFFFFFFFFFFFFFFFFFFFFFFFFFFFFFFFFFFFFHFFFFFHFFFFFFFFFFFFFFFHFFFFHFFFFFFFFFFFFFFFFFFHFFFFFFFFHFFFFFFFHFFFFFFFFFFFFFFFHFF",
    "FFFFFFFFFFFFFFFFFFFFFFFFFFFFFFHFFFFFFFFFFFFHHFHFFFFFFFFFFFFFFFFFFFFFFHFFFFFFFFFFFFFFHFFFHFHFHHFFFFFHFFFHFFFFFFFFFFFFFFFFFFFFFFFF",
    "FFFHFFFFFFFFFFFFFFFFFFFFFFFFFFFFFFFFFFFFFFFFFFFFFFFFFFFFFFFFFHHFFFFFFFFFFFFFFFFHFFFFFFFFFFFFFFFFFFFFFFFFHFFFFFFFFFFFFFHFFFFFFHFF",
    "FFFFHFFFFFFFHFFFFHFFHFFFFFFFFFHFFHFFFFFFFFFFFFFFFHFFFFFFFFFFFFFFFFFFFHFFFFFFFFFFFFHFFFFFFFFFHHFFFFFFFFFFHFFFHFFFFFFFHFHFFFFHFFFF",
    "FFFFFFFFFFFFFFFFFFFFFHFFFFFFFFFFFFFFFFFHHFFFFFFHFFFFFFFFHFFFFFHFFFFHHFFFFFFFFHFFFFFFFFHFHFFFFFFFFFFFFHFFFFFHFFFFFFFFHFFFFHFFFFHF",
    "FFFFHFFHFHFFFFFFFFFFFFFFFFFFFFFHFFHFFFFFFFFFFFFFFHFFFFFFHFFFFFHHFFHFFHFFFFFFFFFFFFFFFFFFFFFFFFFFFFFFFFFFFFFFFHFFFHFFHFFFHFHFHFFF",
    "FFFFFFFFFFFFFHHFFFFFFFHFFFFFFFFFFFFFFFFFFFFFFFFFFHFFHHFFFFFFFFFFFFFFFFFFFFFFFFFFFFHFFFFFFFFFFFFFFFFFFFHFFHFFHFFFFFFHFHFFHFFHFFFF",
    "FFFFFFFFFFFFFFHHFFFFFFFFFFFFFFFFFFFFFFHFFFFFFFFHFFFFFFFHHFHFFFFFFFFFFFFHFHFFFFFFFFFFFFFFFFHFFHFFFFFFFFFFFFFFHFFFFFFFFFFHFFFFHFFG"
  ]
}